###########################
#.........................#
#....#....................#
##D###.D..................#
#....#....................#
#....#....................#
#....#....................#
#.........................#
#...............O.........#
#.........................#
#.........................#
#.........................#
#.........#######.........#
#.........................#
#.........................#
###########################